1111111111
1000000001
1000000001
1000000001
1000000001
1000000001
1000110001
1000010001
1001010001
1011011111
10100010$1
1010001001
1010010011
1010000001
1111111111